/Products/Search?endCategory=Antenna__Evaluation__Board	Antenna Evaluation Board (68)
/Products/Search?endCategory=Antenna__Evaluation__Kit	Antenna Evaluation Kit (7)
/Products/Search?endCategory=Antenna__Hardware-slash-Accessory	Antenna Hardware/Accessory (969)
/Products/Search?endCategory=Antenna__Unit	Antenna Unit (2158)
/ProductCategory/AllCategories/Circuit__Breakers?level=1	Circuit Breakers (24)
/ProductCategory/AllCategories/Electromechanical__Switches?level=1	Electromechanical Switches (4365)
/ProductCategory/AllCategories/EMI-slash-Shielding?level=1	EMI/Shielding (821)
/ProductCategory/AllCategories/Fuses?level=1	Fuses (8)
/ProductCategory/AllCategories/Relays?level=1	Relays (901)
/ProductCategory/AllCategories/Thermal__Management?level=1	Thermal Management (2396)
/Products/Search?endCategory=Tuning__Element	Tuning Element (73)
/ProductCategory/AllCategories/Broadcast?level=1	Broadcast (17)
/ProductCategory/AllCategories/RF__Modules?level=1	RF Modules (98)
/Products/Search?endCategory=Comb__Generator	Comb Generator (10)
/Products/Search?endCategory=Downconverter	Downconverter (79)
/Products/Search?endCategory=Frequency__Control__Evaluation__Board	Frequency Control Evaluation Board (445)
/Products/Search?endCategory=Frequency__Divider-slash-Prescaler	Frequency Divider/Prescaler (91)
/Products/Search?endCategory=Frequency__Multiplier	Frequency Multiplier (126)
/Products/Search?endCategory=Modulator-slash-Demodulator	Modulator/Demodulator (117)
/ProductCategory/AllCategories/Oscillators?level=1	Oscillators (2845)
/Products/Search?endCategory=Phase__Discriminator	Phase Discriminator (2)
/Products/Search?endCategory=Phase__Shifter	Phase Shifter (76)
/Products/Search?endCategory=Phase-Lock-Loop__(PLL)	Phase-Lock-Loop (PLL) (119)
/Products/Search?endCategory=Power__Detector	Power Detector (30)
/ProductCategory/AllCategories/Resonators?level=1	Resonators (2253)
/Products/Search?endCategory=RF__Mixer	RF Mixer (523)
/Products/Search?endCategory=SAW__Filter__and__Resonator__Kit	SAW Filter and Resonator Kit (6)
/Products/Search?endCategory=Synthesizer	Synthesizer (190)
/ProductCategory/AllCategories/Timing__Modules?level=1	Timing Modules (45)
/Products/Search?endCategory=Up-slash-Down__Converter	Up/Down Converter (67)
/ProductCategory/AllCategories/Adapters?level=1	Adapters (2798)
/ProductCategory/AllCategories/Cable__Assemblies?level=1	Cable Assemblies (14493)
/ProductCategory/AllCategories/Connectors?level=1	Connectors (14634)
/Products/Search?endCategory=DC__Block	DC Block (61)
/Products/Search?endCategory=Dust__Cap	Dust Cap (133)
/Products/Search?endCategory=EMP-slash-Lightning__Protector	EMP/Lightning Protector (666)
/Products/Search?endCategory=Equalizer	Equalizer (27)
/Products/Search?endCategory=Header	Header (382)
/Products/Search?endCategory=IC__and__Component__Socket	IC and Component Socket (28)
/Products/Search?endCategory=Interconnect__Accessory	Interconnect Accessory (724)
/Products/Search?endCategory=Interconnect__Kit	Interconnect Kit (121)
/Products/Search?endCategory=Interconnect__Tool	Interconnect Tool (726)
/Products/Search?endCategory=Power__Entry__Module	Power Entry Module (5)
/Products/Search?endCategory=RF__Coaxial__Cable	RF Coaxial Cable (311)
/Products/Search?endCategory=Terminal__Block	Terminal Block (25)
/ProductCategory/AllCategories/Terminals?level=1	Terminals (218)
/ProductCategory/AllCategories/Terminations?level=1	Terminations (773)
/ProductCategory/AllCategories/Waveguide?level=1	Waveguide (24)
/Products/Search?endCategory=Wedgelocks	Wedgelocks (2)
/ProductCategory/AllCategories/Bluetooth?level=1	Bluetooth (59)
/ProductCategory/AllCategories/Cellular__Gateways?level=1	Cellular Gateways (110)
/ProductCategory/AllCategories/Cellular__Modems?level=1	Cellular Modems (4)
/ProductCategory/AllCategories/Cellular__Modules?level=1	Cellular Modules (313)
/ProductCategory/AllCategories/GPS?level=1	GPS (144)
/ProductCategory/AllCategories/ISM__Modules?level=1	ISM Modules (56)
/Products/Search?endCategory=LoRa	LoRa (15)
/Products/Search?endCategory=M2M__Accessory	M2M Accessory (165)
/ProductCategory/AllCategories/WiFi?level=1	WiFi (74)
/ProductCategory/AllCategories/Zigbee?level=1	Zigbee (38)
/ProductCategory/AllCategories/Attenuators?level=1	Attenuators (5718)
/Products/Search?endCategory=Bias__T	Bias T (50)
/ProductCategory/AllCategories/Capacitors?level=1	Capacitors (27477)
/Products/Search?endCategory=Circulator-slash-Isolator	Circulator/Isolator (239)
/ProductCategory/AllCategories/Delay__Lines?level=1	Delay Lines (23)
/ProductCategory/AllCategories/Dividers-slash-Combiners?level=1	Dividers/Combiners (447)
/ProductCategory/AllCategories/Filters?level=1	Filters (1178)
/ProductCategory/AllCategories/Inductors?level=1	Inductors (430)
/Products/Search?endCategory=Magnetics__-__Core-slash-Toroid	Magnetics - Core/Toroid (14)
/Products/Search?endCategory=Magnetics__-__Miscellaneous	Magnetics - Miscellaneous (1)
/ProductCategory/AllCategories/Magnetics__-__Transformers?level=1	Magnetics - Transformers (467)
/Products/Search?endCategory=Passive__Components__Design__Kit	Passive Components Design Kit (7)
/Products/Search?endCategory=RC__Equalizer__Network	RC Equalizer Network (3)
/ProductCategory/AllCategories/Resistors?level=1	Resistors (4760)
/ProductCategory/AllCategories/RF__Couplers?level=1	RF Couplers (1138)
/Products/Search?endCategory=RF__Crossover	RF Crossover (9)
/Products/Search?endCategory=RF__Signal__Limiter__-__Coaxial	RF Signal Limiter - Coaxial (12)
/Products/Search?endCategory=RF__Termination	RF Termination (333)
/ProductCategory/AllCategories/Transducers?level=1	Transducers (211)
/ProductCategory/AllCategories/Voltage__Suppression?level=1	Voltage Suppression (109)
/ProductCategory/AllCategories/Converter__Modules?level=1	Converter Modules (18713)
/ProductCategory/AllCategories/Diodes?level=1	Diodes (2955)
/Products/Search?endCategory=GaN__Power__Transistor__Test-slash-Evaluation__Product	GaN Power Transistor Test/Evaluation Product (17)
/Products/Search?endCategory=Silicon__Carbide__Modules	Silicon Carbide Modules (86)
/Products/Search?endCategory=Silicon__Carbide__Test-slash-Evaluation__Products	Silicon Carbide Test/Evaluation Products (20)
/Products/Search?endCategory=Silicon__Carbide-slash-Silicon__Hybrid__Modules	Silicon Carbide/Silicon Hybrid Modules (121)
/ProductCategory/AllCategories/Thyristors?level=1	Thyristors (487)
/ProductCategory/AllCategories/Transistors?level=1	Transistors (4116)
/Products/Search?endCategory=Active__RF__Power__Splitters	Active RF Power Splitters (31)
/ProductCategory/AllCategories/Attenuators__-__Active?level=1	Attenuators - Active (434)
/Products/Search?endCategory=Detector-slash-Controller	Detector/Controller (254)
/Products/Search?endCategory=Encoder-slash-Decoder	Encoder/Decoder (22)
/ProductCategory/AllCategories/Linear__ICs?level=1	Linear ICs (25857)
/ProductCategory/AllCategories/Memory?level=1	Memory (3)
/Products/Search?endCategory=Microphone__IC	Microphone IC (1)
/ProductCategory/AllCategories/Multi-Function__ICs?level=1	Multi-Function ICs (178)
/ProductCategory/AllCategories/Optoelectronics?level=1	Optoelectronics (765)
/Products/Search?endCategory=Power__Management__IC	Power Management IC (6657)
/ProductCategory/AllCategories/Processors?level=1	Processors (308)
/ProductCategory/AllCategories/RF__Amplifiers?level=1	RF Amplifiers (3573)
/Products/Search?endCategory=RF__and__mmW__Front__End__Module	RF and mmW Front End Module (195)
/Products/Search?endCategory=RF__Limiter	RF Limiter (44)
/Products/Search?endCategory=Semiconductor__Designer__Kit	Semiconductor Designer Kit (2224)
/ProductCategory/AllCategories/Sensors?level=1	Sensors (191)
/ProductCategory/AllCategories/Standard__Logic?level=1	Standard Logic (608)
/ProductCategory/AllCategories/Switches?level=1	Switches (1366)
/Products/Search?endCategory=TVS__Array	TVS Array (5)
/ProductCategory/AllCategories/Educational__Materials?level=1	Educational Materials (2)
/ProductCategory/AllCategories/Power__Drive__Solutions?level=1	Power Drive Solutions (183)
/ProductCategory/AllCategories/RF__Modules__and__Systems?level=1	RF Modules and Systems (128)
/Products/Search?endCategory=Software	Software (53)
